16
8
10 13 11 13 12 6 13 13 8 13 7 5 13 13 11 10 
10 1 2 1 2 1 2 1 2 1 2 1 2 1 2 10 
10 1 2 1 2 1 2 1 2 1 2 1 2 1 2 10 
10 1 2 1 2 1 2 1 2 1 2 1 2 1 2 10 
10 1 2 1 2 1 2 1 2 1 2 1 2 1 2 10 
10 1 2 1 2 1 2 1 2 1 2 1 2 1 2 10 
10 1 2 1 2 1 2 1 2 1 2 1 2 1 2 10 
9 13 8 5 13 13 12 13 11 13 13 5 13 8 13 9 
