16
8
15 14 13 14 8 6 12 14 7 14 10 11 12 14 13 15 
15 1 2 1 2 1 2 1 2 1 2 1 2 1 2 15 
15 1 2 1 2 1 2 1 2 1 2 1 2 1 2 15 
15 1 2 1 2 1 2 1 2 1 2 1 2 1 2 15 
15 1 2 1 2 1 2 1 2 1 2 1 2 1 2 15 
15 1 2 1 2 1 2 1 2 1 2 1 2 1 2 15 
15 1 2 1 2 1 2 1 2 1 2 1 2 1 2 15 
16 14 8 5 14 12 6 14 13 12 14 5 14 7 14 16 
